1111111111111
10P0000000C11
1111001111001
100000E100001
1111111111111