1111111111111111111111111111111111
10000000000000C00000C0000000000001
1010010100100000101001000000010101
1010010010101010001001000000010101
10000E0001100000000000011000000001
1000000100000C00000P00000110000001
10000C0000011000000000000000C00001
1000000100000000000000000100000001
110000000C00C0000000000000000000C1
1111111111111111111111111111111111