1111111111111111111111111111111111
1000000000000000000000000000000N01
1010010100100000101001000000010101
1010010010101010001001000000010101
10000E0001100000000000011000000001
1000000100000C00000P00000110000001
10000C00000110C0000000000000C00001
100000010000000000000N000100000001
110000000C00C0000000000000000000C1
1111111111111111111111111111111111