1111111111111111111111111111111111
1N00000N000000C00000C0000000000001
10100101001000001010010000N0010101
1010010010101010001001000N00010101
10000EN001100000N00000011000000001
1000N00100000C00000P00000110000001
10000C0000011000000N00000000C00001
10N00001000000N00N0000000100N00001
110000000C00C00000000N0000000000C1
1111111111111111111111111111111111